1 200 1 1 1 1 1 0 1 1 1 1 1 1 1 1 1 1 1 1 1 1
1 0 1 1 1 1 1 0 1 0 0 0 1 0 0 0 0 0 0 1 1 1
1 0 1 1 1 1 1 0 1 0 1 0 1 0 1 1 1 1 0 1 1 1
1 0 1 1 1 1 1 0 1 0 1 0 1 0 1 1 1 1 0 1 1 1
1 0 1 1 1 1 1 0 1 0 1 0 0 0 1 1 1 1 0 1 1 1
1 0 1 1 1 1 1 0 1 0 1 1 1 1 1 1 1 1 0 1 1 1
1 0 1 1 1 1 1 0 1 0 1 1 1 1 1 1 1 1 0 1 1 1
1 0 1 1 1 1 1 0 1 0 0 0 0 1 1 1 1 1 0 1 1 1
1 0 1 1 1 1 1 0 1 1 1 1 0 1 1 1 1 1 0 1 1 1
1 0 1 1 1 1 1 0 1 1 1 1 0 1 1 1 1 1 0 1 1 1
1 0 1 1 1 1 1 0 1 1 1 0 0 1 1 1 1 1 0 1 1 1
1 0 1 1 1 1 1 0 1 1 1 0 1 1 1 1 1 1 0 1 1 1
1 0 1 1 1 1 1 0 1 1 0 0 1 1 1 1 1 1 0 1 1 1
1 0 1 1 1 1 1 0 1 0 0 1 1 1 1 1 1 1 0 1 1 1
1 0 1 1 1 1 1 0 0 0 1 1 1 1 1 1 1 1 0 1 1 1
1 0 1 1 1 1 1 1 1 1 1 1 1 1 1 1 1 1 0 1 1 1
1 0 1 1 1 1 1 1 1 1 1 1 1 1 1 1 1 1 0 1 1 1
1 0 1 1 1 1 1 1 1 1 1 1 1 1 1 1 1 1 0 1 1 1
1 0 0 0 0 0 0 0 0 0 0 0 0 0 0 0 0 0 0 1 1 1
1 1 1 1 1 1 1 1 1 1 1 1 1 1 1 1 1 1 1 1 1 1
1 1 1 1 1 1 1 1 1 1 100 110 1 1 1 1 1 210 220 230 1 1 1
1 1 1 1 1 1 1 1 1 1 1 1 1 1 1 1 1 1 1 1 1 1